数据：加括号表示可能没有
URL->URL

用户名->UserName
（签名）->Signature
（勋章）->Medal
关注数->AttentionNum
粉丝数->Fans
访客数->NumSpaceVisited
等级->LevelUserGroup
（身份）->levelAdminstrator
总积分->MemberPoints
（认证）->Qualification

UID->UID
会员头衔->VIPTitle
（系统头衔）->SysTitle
在线时间->TimeOnLine
性别->Sex
生日->Birthday
现居住地->CurrentResidence
家乡->Hometown
支付宝账号->Apliy
个人主页->HomePage
自我介绍->SelfIntroduce
注册时间->RegistrationData
最后登录时间->DataLastAccessed

精华帖子数->EssencePosts
帖子数->NumReply
平均日发帖数->PostsPerDay
帖子签名->PostsSignature

QQ->QQ
Msn->MSN

工作经历->WorkExperience
教育经历->EducationExperience





