数据：加括号表示可能没有
url->URL
用户名->UserName
uid->UID
空间访问量->NumSpaceVisited
邮箱状态->EmailStatus
视频认证->VideoAuthenticationStatus
（自定义头衔）->Title
个人签名->Signature
统计信息
 |-好友数->NumFriends
 |-回帖数->NumReply
 |-主题数->NumPost
性别->Sex
生日->Birthday
（学历）->Education
（QQ）->QQ
（阿里旺旺）->Alitalk
（个人主页）->HomePage
（勋章）->Medal
（管理以下板块）->AdminModule
（管理组）->LevelAdministrator
用户组->LevelUserGroup
在线时间->TimeOnLine
注册时间->RegistrationData
最后访问->DateLastAccessed
（注册IP）->IPRegistered
（上次访问IP）->IPLastVisited
上次活动时间->DateLastActivity
上次发表时间->DateLastPosted
所在时区->TimeZone
已用空间->UsedSpace
（买家好评度）->TheBuyersRating
（卖家好评度）->TheSellerRating
积分->MemberPoint
银行->BankCardInformation
信用->Credit
I币->I-Money
M币->M-Money
推广->NumExpanded
娱乐->Entertainment
捐赠->Donations
贡献->Contribution
